111111
1000C1
11E0P1
101001
111111
