111111111111111111111111111111111
110000000000000C00000C0000P0000011
101001010010000010100100000001011
1010010010101E100010010000000101111
110000000C00C0000000000000C000001
111111111111111111111111111111111
