1111111111111111111111111111111111
11000000000000000000000000P0000011
1010010100100000101001000000010101
1010010010101E10001001000000010101
1100000000000000000000000000000011
1111111111111111111111111111111111
